simple_2
8,8,8,8,8,8,8,8,8,8,8,8
8,0,0,0,0,0,0,0,0,0,0,8
8,0,6,0,0,0,0,0,0,0,0,8
8,0,0,0,0,0,0,0,0,0,0,8
8,0,0,0,0,0,0,0,0,0,0,8
8,0,0,0,0,0,0,0,0,0,0,8
8,0,0,0,0,0,0,0,0,1,0,8
8,0,0,0,0,0,0,0,0,0,0,8
8,0,0,0,0,0,0,0,0,0,0,8
8,0,0,0,0,0,0,0,0,0,0,8
8,0,0,0,0,0,0,0,0,0,0,8
8,8,8,8,8,8,8,8,8,8,8,8
